Date,BEDCAP_ICU,VENTCAP_ICU,BEDCAP_OTHER,VENTCAP_OTHER,COVID_NEWICU,COVID_ICU,COVID_NEWOTHER,COVID_OTHER,COVID_VENT,VENTCAP_TOTAL,NONCOVID_ICU,NONCOVID_OTHER,NONCOVID_VENT,COVID_HOSP
2020-04-01,2813,2056,30121,525,0,193,0,327,127,2581,167,6514,106,520
2020-04-02,2852,2087,30168,546,0,225,0,346,155,2633,0,6514,0,571
2020-04-03,2852,2087,30036,546,0,228,0,368,167,2633,0,6514,0,596
2020-04-04,2852,2087,30401,546,0,233,0,435,169,2633,0,6514,0,668
2020-04-05,2852,2087,30741,546,0,254,0,443,177,2633,0,6514,0,697
2020-04-06,4148,2087,46589,546,0,433,0,838,322,2633,0,6514,0,1271
2020-04-07,4148,2087,46570,546,0,461,0,893,348,2633,0,6514,0,1354
2020-04-08,4148,2739,47310,604,0,493,0,951,380,3343,164,6613,90,1444
2020-04-09,5059,3579,57209,604,0,544,51,1110,438,4183,1426,23405,417,1654
2020-04-10,5059,3579,56977,604,40,498,90,1218,380,4183,1415,23372,404,1716
2020-04-11,5099,3579,57613,604,12,509,125,1266,367,4183,1033,17551,379,1775
2020-04-12,5099,3579,57485,604,13,519,138,1313,382,4183,1030,17673,380,1832
2020-04-13,5099,3579,57482,604,11,500,164,1411,374,4183,1510,24941,396,1911
2020-04-14,5100,3580,57687,606,15,529,181,1426,377,4186,1510,25359,395,1955
2020-04-15,5368,3877,59375,564,11,522,159,1517,382,4441,1681,26036,508,2039
2020-04-16,6552,3881,59903,564,12,527,157,1547,373,4445,1448,27944,454,2074
2020-04-17,6552,3881,59479,564,15,525,213,1614,365,4445,1388,25589,448,2139
2020-04-18,6548,3889,59286,564,2,515,136,1635,363,4453,1368,25819,386,2150
2020-04-19,6548,3874,59316,564,22,534,195,1737,366,4438,1231,21453,424,2271
2020-04-20,6548,3854,59873,610,15,530,170,1813,364,4464,1466,26873,457,2343
2020-04-21,6548,3854,59901,610,13,524,202,1882,362,4464,1587,28912,480,2406
2020-04-22,6566,3854,59587,571,18,516,309,2044,352,4425,1667,26864,527,2560
2020-04-23,6566,3854,59492,571,20,541,214,2091,379,4425,1612,28750,496,2632
2020-04-24,6563,3853,59560,571,13,525,214,2164,380,4424,1524,26726,446,2689
2020-04-25,6563,3853,59656,571,8,525,150,2183,374,4424,1525,27013,428,2708
2020-04-26,6563,3853,59154,571,14,519,166,2226,372,4424,1325,22060,433,2745
2020-04-27,6563,3853,59168,571,12,520,238,2335,374,4424,1579,27377,478,2855
2020-04-28,6562,3852,59659,571,9,525,226,2374,367,4423,1683,29626,507,2899
2020-04-29,6647,3937,62225,579,12,510,247,2444,355,4516,1750,27989,570,2954
2020-04-30,6647,3937,62227,579,11,502,203,2441,350,4516,1620,29814,491,2943
2020-05-01,6647,3937,61677,579,18,497,204,2481,326,4516,1618,27470,467,2978
2020-05-02,6647,3937,61457,579,9,498,182,2493,345,4516,1633,27408,439,2991
2020-05-03,6647,3937,62089,579,12,491,135,2573,340,4516,1323,21563,424,3064
2020-05-04,6647,3937,62326,579,19,490,211,2611,332,4516,1758,30477,477,3101
2020-05-05,6647,3937,62415,579,12,482,191,2638,339,4516,1689,28723,472,3120
2020-05-06,6644,3934,62513,595,15,489,181,2614,321,4529,1814,29296,547,3103
2020-05-07,6647,3937,62642,648,4,466,187,2621,327,4585,1711,30897,444,3087
2020-05-08,6645,3935,62094,650,11,452,177,2587,308,4585,1618,28617,421,3039
2020-05-09,6645,3935,62455,650,13,440,130,2649,285,4585,1646,28640,391,3089
2020-05-10,6645,3935,62516,650,4,429,112,2660,289,4585,1313,22349,417,3089
2020-05-11,6645,3935,62683,650,5,417,148,2667,284,4585,1966,31322,548,3084
2020-05-12,6645,3935,61902,670,11,420,177,2701,288,4605,1722,29157,462,3121
2020-05-13,6647,3937,62707,668,10,408,184,2628,290,4605,1757,29784,448,3036
2020-05-14,6650,3937,62525,672,9,401,148,2663,280,4609,1968,29931,546,3064
2020-05-15,6650,3937,62335,672,37,395,295,2616,269,4609,1756,29192,445,3011
2020-05-16,6650,3937,62451,672,10,381,146,2621,260,4609,1699,28881,424,3002
2020-05-17,5943,3937,52060,672,7,368,118,2582,248,4609,1357,22394,421,2950
2020-05-18,6650,3937,62181,672,13,374,111,2654,250,4609,1711,29374,436,3028
2020-05-19,6650,3937,62577,672,15,371,130,2405,246,4609,1856,32022,504,2776
2020-05-20,6650,3937,62514,672,5,355,115,2354,235,4609,1995,30564,574,2709
2020-05-21,6638,3937,62490,672,11,346,137,2288,235,4609,1872,32615,466,2634
2020-05-22,6638,3937,61947,672,4,336,128,2231,230,4609,1785,29932,468,2567
2020-05-23,6638,3937,61725,672,7,340,72,2185,215,4609,1823,29662,423,2525
2020-05-24,5943,3937,51494,672,14,340,74,2143,223,4609,1453,23190,403,2483
2020-05-25,6579,3878,62670,747,12,344,120,2180,224,4625,2111,33049,598,2524
2020-05-26,6579,3878,62605,747,9,350,98,2123,229,4625,1844,31326,488,2473
2020-05-27,6579,3878,62706,747,1,332,120,2089,207,4625,1905,31693,496,2421
2020-05-28,6579,3878,62697,747,8,319,171,2004,206,4625,1983,33514,502,2323
2020-05-29,6579,3878,62308,747,3,304,91,1949,187,4625,1866,30908,470,2253
2020-05-30,6579,3878,62727,747,7,304,75,1935,201,4625,1797,31195,440,2239
2020-05-31,6579,3878,62734,747,1,302,69,1942,197,4625,1437,24242,419,2244
2020-06-01,6579,3878,62596,747,7,300,83,1917,186,4625,2160,33603,589,2217
2020-06-02,6579,3878,62741,747,5,301,79,1870,193,4625,1923,31968,497,2171
2020-06-03,6579,3878,62650,747,8,284,79,1804,182,4625,1903,31880,477,2088
2020-06-04,6579,3878,62627,747,2,265,54,1674,179,4625,1911,31961,487,1939
2020-06-05,6579,3878,62750,747,2,261,71,1584,179,4625,1905,31457,501,1845
2020-06-06,6579,3878,62736,747,3,262,41,1541,179,4625,1498,23898,442,1803
2020-06-07,6579,3878,62685,747,1,252,52,1555,163,4625,1478,24199,432,1807
2020-06-08,6429,3728,62840,897,4,249,52,1522,165,4625,2192,34006,595,1771
2020-06-09,6429,3728,61659,897,5,252,39,1420,160,4625,1951,31521,523,1672
2020-06-10,6429,3728,62833,897,5,249,57,1363,156,4625,1969,32486,517,1612
2020-06-11,6429,3728,62828,897,3,237,45,1313,149,4625,1998,34265,528,1550
2020-06-12,6429,3728,62585,897,4,227,86,1220,129,4625,1902,31676,459,1447
2020-06-13,6429,3728,62818,897,0,203,32,1193,135,4625,1867,31636,446,1396
2020-06-14,5734,3728,52293,897,3,199,30,1173,114,4625,1478,24498,462,1372
2020-06-15,6425,3728,63040,897,1,193,23,1120,119,4625,2196,34476,598,1313
2020-06-16,6425,3728,63052,897,1,182,39,1046,111,4625,1976,32931,533,1228
2020-06-17,6425,3728,62611,897,0,166,32,983,104,4625,2027,32818,531,1149
2020-06-18,6425,3728,62306,897,1,159,80,910,107,4625,2093,34371,549,1069
2020-06-19,6425,3728,62938,897,1,158,32,823,107,4625,1983,32553,533,981
2020-06-20,6425,3728,62942,897,2,166,31,794,101,4625,1580,24986,466,960
2020-06-21,6425,3728,62854,897,0,151,29,806,100,4625,1554,25193,458,957
2020-06-22,6425,3728,65648,897,1,145,89,796,94,4625,2341,37033,667,941
2020-06-23,6425,3728,65629,897,3,142,32,781,85,4625,2122,35368,592,923
2020-06-24,6425,3728,65595,897,1,135,28,750,85,4625,2077,35442,597,885
2020-06-25,6425,3728,65565,897,5,127,38,744,79,4625,2159,37433,595,871
2020-06-26,6425,3728,65682,897,1,114,38,714,68,4625,2043,34864,536,828
2020-06-27,6425,3728,65044,897,2,110,19,715,68,4625,1565,25015,453,825
2020-06-28,6425,3728,65283,897,3,107,27,698,65,4625,1604,25547,473,805
2020-06-29,6425,3728,65235,897,3,95,25,688,61,4625,2411,37566,647,783
2020-06-30,6425,3728,65511,897,2,91,30,622,52,4625,2099,35779,572,713
2020-07-01,6425,3728,65399,897,3,87,28,617,45,4625,1567,25752,441,704
2020-07-02,6425,3728,65508,897,3,87,20,591,48,4625,2146,37649,542,678
2020-07-03,6425,3728,65355,897,0,81,15,576,48,4625,2036,35239,530,657
2020-07-04,6425,3728,65437,897,0,79,20,566,46,4625,1924,33299,420,645
2020-07-05,6425,3728,65470,897,0,73,21,572,43,4625,1624,25785,428,645
2020-07-06,6484,3787,64998,838,0,71,15,530,41,4625,2458,38020,627,601
2020-07-07,6484,3787,65405,838,3,73,23,508,43,4625,2222,36554,555,581
2020-07-08,6484,3787,65390,838,1,68,25,476,36,4625,2178,37805,603,544
2020-07-09,6484,3787,65347,838,1,72,54,492,36,4625,2263,38611,595,564
2020-07-10,6484,3787,65319,838,0,67,22,469,29,4625,2128,35946,561,536
2020-07-11,6484,3787,65305,838,1,66,16,478,30,4625,1989,33828,435,544
2020-07-12,6484,3787,65343,838,1,68,25,483,30,4625,1649,26296,419,551
2020-07-13,6484,3787,65394,838,2,71,15,452,34,4625,2415,38689,528,523
2020-07-14,6484,3787,65402,838,1,65,25,446,35,4625,2187,36883,546,511
2020-07-15,6484,3787,64986,838,2,62,20,445,33,4625,2162,36618,574,507
2020-07-16,6484,3787,65005,838,0,67,29,429,32,4625,2255,38663,563,496
2020-07-17,6484,3787,64227,838,1,65,26,427,32,4625,2145,35503,524,492
2020-07-18,6484,3787,65136,838,2,67,20,441,34,4625,1635,26097,451,508
2020-07-19,6484,3787,65387,838,1,71,34,442,35,4625,1619,26408,410,513
2020-07-20,6484,3787,65327,838,2,72,20,455,42,4625,2403,38863,653,527
2020-07-21,6484,3787,65329,838,3,74,25,472,38,4625,2128,36944,549,546
2020-07-22,6484,3787,65346,838,0,73,40,451,41,4625,2154,36915,524,524
2020-07-23,6484,3787,65091,838,3,67,13,398,42,4625,2218,38999,551,465
2020-07-24,6484,3787,65256,838,0,65,13,377,42,4625,2141,36250,554,442
2020-07-25,6484,3787,65237,838,0,63,30,363,43,4625,1606,26219,405,426
2020-07-26,6484,3787,65165,838,0,62,40,376,40,4625,1609,26614,408,438
2020-07-27,6484,3787,65354,838,1,61,26,362,37,4625,2492,38766,652,423
2020-07-28,6484,3787,65294,838,1,62,21,341,37,4625,2189,37009,518,403
2020-07-29,6484,3787,65294,838,5,71,59,344,37,4625,2214,36986,530,415
2020-07-30,6484,3787,66625,838,2,69,28,313,40,4625,2270,38826,548,382
2020-07-31,6484,3787,65281,838,1,71,14,296,37,4625,2055,34347,455,367
2020-08-01,6484,3787,65134,838,0,74,11,290,39,4625,1606,26032,443,364
2020-08-02,6484,3787,65110,838,2,76,18,287,38,4625,1595,26167,433,363
2020-08-03,6484,3787,64847,838,2,84,15,263,40,4625,1724,28447,451,347
2020-08-04,6484,3787,64966,838,2,84,20,263,44,4625,2383,36736,632,347
2020-08-05,6484,3787,65360,838,1,85,14,245,42,4625,2169,37232,533,330
2020-08-06,6484,3787,65397,838,1,81,28,218,38,4625,2251,39287,545,299
2020-08-07,6484,3787,65275,838,3,77,17,227,36,4625,2157,36584,527,304
2020-08-08,6484,3787,65164,838,2,75,8,224,38,4625,1621,26327,436,299
2020-08-09,6484,3787,65178,838,0,70,10,234,41,4625,1636,26603,411,304
2020-08-10,6508,3811,65405,814,2,67,9,214,35,4625,2507,39188,684,281
2020-08-11,6508,3811,65323,814,3,66,9,204,32,4625,2196,37549,542,270
2020-08-12,6508,3811,65446,814,2,69,24,198,32,4625,2174,37754,542,267
2020-08-13,6508,3811,65269,814,2,67,21,232,30,4625,2211,39042,581,299
2020-08-14,6508,3811,65335,814,0,66,15,201,31,4625,2148,36800,550,267
2020-08-15,6508,3811,65302,814,1,66,16,197,30,4625,1642,26572,450,263
2020-08-16,6508,3811,64953,814,1,61,5,202,30,4625,1663,26560,462,263
2020-08-17,6508,3811,65470,814,4,63,13,196,29,4625,2509,39566,679,259
2020-08-18,6508,3811,65048,816,0,63,10,193,24,4627,2231,37513,567,256
2020-08-19,6508,3811,65209,816,0,62,41,193,23,4627,2216,37646,585,255
2020-08-20,6508,3811,65034,816,0,56,9,190,22,4627,2307,39483,564,246
2020-08-21,6508,3811,65353,816,0,50,10,190,20,4627,2190,37144,520,240
2020-08-22,6508,3811,64992,816,0,45,7,185,20,4627,1642,26444,399,230
2020-08-23,6508,3811,65436,816,0,43,12,183,22,4627,1671,27149,419,226
2020-08-24,6508,3811,65374,846,0,42,17,196,22,4657,2542,39581,692,238
2020-08-25,6508,3811,65408,846,0,45,13,197,21,4657,2250,37934,555,242
2020-08-26,6508,3811,64889,846,3,50,19,211,22,4657,2248,37522,550,261
2020-08-27,6508,3811,65008,846,1,52,14,200,24,4657,1893,31514,581,252
2020-08-28,6508,3811,65269,846,1,52,10,197,16,4657,1777,29009,455,249
2020-08-29,6508,3811,65104,846,1,54,12,190,23,4657,1711,26713,463,244
2020-08-30,6508,3811,65350,846,2,58,17,203,21,4657,1680,27060,463,261
2020-08-31,6508,3811,65355,816,3,60,10,208,17,4627,2465,39524,672,268
2020-09-01,6508,3811,65474,816,1,56,18,213,23,4627,2202,37811,549,269
2020-09-02,6508,3811,65457,816,1,58,9,206,28,4627,2178,37665,556,264
2020-09-03,6508,3811,65367,816,1,55,17,208,25,4627,2270,39599,589,263
2020-09-04,6508,3811,65432,816,1,58,11,190,27,4627,2174,36943,564,248
2020-09-05,5813,3811,54733,816,2,49,18,177,21,4627,1680,26502,443,226
2020-09-06,5813,3811,54915,816,1,50,10,177,21,4627,1679,26623,458,227
2020-09-07,5813,3811,54955,816,1,45,10,181,21,4627,1797,29230,491,226
2020-09-08,6508,3811,65474,816,1,52,23,210,25,4627,2434,37625,713,262
2020-09-09,6508,3811,65485,816,0,52,15,217,26,4627,2273,37891,595,269
2020-09-10,6508,3811,65444,816,0,53,21,217,27,4627,2378,40016,620,270
2020-09-11,6508,3811,65344,816,5,48,20,229,27,4627,2250,37295,592,277
2020-09-12,6508,3811,65337,816,2,54,16,229,29,4627,1707,27106,470,283
2020-09-13,6508,3811,65016,816,0,55,14,225,28,4627,1716,26881,452,280
2020-09-14,6508,3811,65101,815,6,68,23,231,31,4626,2606,39875,692,299
2020-09-15,6508,3811,65472,815,3,74,18,233,34,4626,2291,38371,570,307
2020-09-16,6480,3792,65650,834,5,84,25,236,33,4626,2286,38715,557,320
2020-09-17,6480,3792,65660,834,0,80,26,248,34,4626,2367,40917,607,328
2020-09-18,6480,3792,65592,834,2,82,16,249,35,4626,2253,37988,602,331
2020-09-19,6480,3792,65519,834,2,87,19,254,38,4626,1730,27594,496,341
2020-09-20,6480,3792,65558,834,3,88,36,281,43,4626,1705,27774,498,369
2020-09-21,6480,3792,65558,834,5,86,41,313,46,4626,2575,40290,705,399
2020-09-22,6480,3792,65598,834,2,93,24,327,42,4626,2296,38529,553,420
2020-09-23,6480,3792,65600,834,4,94,28,340,43,4626,2317,38536,604,434
2020-09-24,6480,3792,65441,855,6,100,38,362,45,4647,2378,40933,620,462
2020-09-25,6480,3792,65563,855,10,115,53,382,44,4647,2270,38350,596,497
2020-09-26,6480,3792,65089,855,1,114,47,396,46,4647,1734,27511,438,510
2020-09-27,6480,3792,64903,855,1,110,25,405,48,4647,1731,27508,442,515
2020-09-28,6480,3792,65242,855,6,114,57,448,46,4647,2583,40543,744,562
2020-09-29,6480,3792,65671,855,3,120,58,464,46,4647,2360,39026,585,584
2020-09-30,6480,3792,65592,855,8,125,56,485,47,4647,2257,39241,542,610
2020-10-01,6480,3792,65291,855,8,129,56,479,50,4647,2372,41061,620,608
2020-10-02,6480,3792,65400,855,9,141,66,496,55,4647,2219,38391,581,637
2020-10-03,6480,3792,65368,855,7,147,44,508,57,4647,1697,27746,465,655
2020-10-04,6480,3792,65368,855,4,141,61,557,55,4647,1744,27730,447,698
2020-10-05,6480,3792,65703,855,12,146,58,589,61,4647,2551,40449,699,735
2020-10-06,6480,3792,65385,855,6,143,68,621,62,4647,2280,38411,586,764
2020-10-07,4984,2293,65653,855,13,151,71,670,66,3148,2283,38846,647,821
2020-10-08,4984,2293,65698,855,3,150,76,670,64,3148,2346,40937,631,820
2020-10-09,4984,2293,65340,855,4,160,90,664,70,3148,2085,35571,519,824
2020-10-10,4984,2293,63461,855,3,161,57,650,72,3148,1655,25745,478,811
2020-10-11,4984,2293,64335,855,7,170,68,692,71,3148,1649,26216,464,862
2020-10-12,4984,2293,64148,855,14,186,46,687,76,3148,1761,28415,482,873
2020-10-13,4984,2293,65505,855,3,191,77,739,88,3148,2340,37898,668,930
2020-10-14,4986,2298,65309,855,9,191,61,756,95,3153,2234,38520,596,947
2020-10-15,4986,2298,65531,855,7,198,63,781,98,3153,2316,40728,614,979
2020-10-16,4986,2296,65464,855,4,206,66,754,102,3151,2209,37990,611,960
2020-10-17,4986,2298,65454,855,4,209,71,771,101,3153,1731,27827,473,980
2020-10-18,5029,2335,65362,855,7,209,64,790,100,3190,1742,27925,472,999
2020-10-19,5029,2335,65490,855,12,218,80,808,108,3190,2517,40641,724,1026
2020-10-20,5029,2335,65474,855,4,210,88,828,116,3190,2257,38846,632,1038
2020-10-21,5029,2335,65408,855,5,225,63,809,122,3190,2272,38907,629,1034
2020-10-22,5029,2335,65442,855,2,228,77,828,120,3190,2309,40793,653,1056
2020-10-23,5029,2335,64414,911,6,228,73,841,124,3246,2192,37161,642,1069
2020-10-24,5029,2335,64863,911,6,233,101,870,124,3246,1722,27222,494,1103
2020-10-25,5029,2335,64845,911,3,232,49,889,121,3246,1714,27534,489,1121
2020-10-26,5029,2335,64879,911,8,229,71,922,123,3246,2528,40010,713,1151
2020-10-27,5029,2335,65206,911,4,228,86,952,124,3246,2274,38272,629,1180
2020-10-28,5029,2335,65403,911,2,223,72,943,119,3246,2262,38698,644,1166
2020-10-29,5029,2335,65395,911,3,227,79,969,117,3246,2378,41105,638,1196
2020-10-30,5029,2335,65311,911,8,228,75,968,122,3246,2214,37700,634,1196
2020-10-31,5029,2335,65315,911,3,224,55,990,114,3246,1725,27174,506,1214
2020-11-01,5029,2335,64945,911,5,227,59,1032,112,3246,1769,26997,543,1259
2020-11-02,5015,2321,64975,911,7,229,109,1094,121,3232,2358,39708,655,1323
2020-11-03,5015,2321,64638,911,6,235,93,1114,126,3232,2309,39455,688,1349
2020-11-04,5062,2374,65570,911,5,252,99,1102,131,3285,2299,40216,686,1354
2020-11-05,5062,2374,63926,911,3,242,104,1149,127,3285,2416,41022,656,1391
2020-11-06,5073,2385,65449,911,6,254,97,1131,132,3296,2180,37530,591,1385
2020-11-07,5073,2385,64938,911,5,259,103,1136,130,3296,2112,35340,521,1395
2020-11-08,5087,2399,65426,911,11,271,108,1218,137,3310,1728,27478,507,1489
2020-11-09,5089,2954,65483,1216,15,279,110,1249,135,4170,2389,42256,835,1528
2020-11-10,5168,2958,65935,1216,21,300,172,1323,148,4174,1955,31571,696,1623
2020-11-11,5168,2958,66559,1216,7,320,131,1353,156,4174,2146,36629,688,1673
2020-11-12,5168,2958,66528,1216,11,333,145,1415,172,4174,2343,42420,765,1748
2020-11-13,5172,2972,66281,1216,8,342,156,1428,177,4188,2236,39562,748,1770
2020-11-14,5172,2972,66526,1216,9,363,140,1438,178,4188,2136,37164,547,1801
2020-11-15,5172,2972,66550,1216,14,377,115,1457,180,4188,1759,29065,512,1834
2020-11-16,5184,2984,66354,1216,19,402,175,1531,200,4200,2311,41765,668,1933
2020-11-17,5184,2984,66668,1216,9,403,161,1577,210,4200,2279,40477,790,1980
2020-11-18,5184,2984,66668,1216,9,423,157,1570,217,4200,2261,40107,764,1993
2020-11-19,5184,2985,66480,1216,13,419,169,1540,229,4201,2302,42030,771,1959
2020-11-20,5189,2985,62046,1216,11,420,189,1584,224,4201,2186,36174,691,2004
2020-11-21,5148,2986,62064,1216,13,422,170,1646,225,4202,2096,33921,498,2068
2020-11-22,5190,2986,61643,1216,17,443,172,1661,231,4202,1689,28338,501,2104
2020-11-23,5193,2989,61321,1216,13,449,176,1760,236,4205,2261,38231,692,2209
2020-11-24,5169,3003,58858,1202,9,451,187,1802,239,4205,2193,34403,741,2253
2020-11-25,5171,3007,59260,1202,16,442,195,1843,248,4209,2233,34494,734,2285
2020-11-26,5173,3007,59053,1203,25,455,203,1992,241,4210,2314,36157,779,2447
2020-11-27,5178,3011,59302,1204,26,465,196,2033,232,4215,2155,33694,757,2498
2020-11-28,5179,3012,59164,1204,13,470,161,2071,228,4216,2066,26768,526,2541
2020-11-29,5179,3012,59270,1204,17,487,150,2109,247,4216,1720,26553,567,2596
2020-11-30,5186,3012,59922,1203,16,519,191,2195,254,4215,2252,36099,772,2714
2020-12-01,5185,3011,59456,1203,28,525,192,2251,260,4214,2173,34442,769,2776
2020-12-02,5185,3011,59127,1203,31,544,241,2284,263,4214,2118,33863,757,2828
2020-12-03,5185,3011,59436,1203,20,556,183,2345,262,4214,2189,36130,750,2901
2020-12-04,5238,3045,59580,1214,14,556,218,2406,259,4259,2001,31629,590,2962
2020-12-05,5238,3045,59526,1214,21,562,194,2462,254,4259,1686,26332,539,3024
2020-12-06,5238,3045,59561,1214,20,573,162,2555,267,4259,1671,26318,511,3128
2020-12-07,5238,3045,59466,1214,16,589,191,2604,283,4259,2194,35311,770,3193
2020-12-08,5238,3045,59753,934,16,602,205,2577,266,3979,2149,33864,787,3179
2020-12-09,5238,3045,59481,934,13,606,192,2525,280,3979,2161,33686,775,3131
2020-12-10,5238,3045,59400,934,39,646,242,2582,274,3979,2270,35659,782,3228
2020-12-11,5237,3040,59587,933,20,650,194,2557,300,3973,2143,33065,656,3207
2020-12-12,5237,3040,59175,933,16,659,201,2577,298,3973,2012,30856,528,3236
2020-12-13,5237,3040,59655,933,13,651,191,2692,311,3973,1681,26114,533,3343
2020-12-14,5237,3040,59417,933,20,659,283,2826,322,3973,2236,34908,787,3485
2020-12-15,5237,3040,59562,933,19,681,216,2767,333,3973,2150,33646,740,3448
2020-12-16,5237,3040,59092,933,27,697,275,2771,360,3973,2125,32945,740,3468
2020-12-17,5237,3040,59656,933,16,696,236,2778,354,3973,2221,35126,782,3474
2020-12-18,5099,2913,57105,713,20,681,227,2650,313,3626,2054,30609,656,3331
2020-12-19,5099,2913,56839,713,20,684,203,2695,317,3626,1984,30133,508,3379
2020-12-20,5099,2913,57011,713,15,679,236,2832,316,3626,1639,25149,511,3511
2020-12-21,5099,2913,57055,713,12,681,231,2845,333,3626,2056,31853,655,3526
2020-12-22,5099,2913,57148,713,22,681,249,2821,347,3626,1944,29769,666,3502
2020-12-23,5099,2913,57075,713,16,678,254,2784,338,3626,1880,28646,650,3462
2020-12-24,5099,2916,56188,713,7,673,157,2607,311,3629,1821,26973,608,3280
2020-12-25,5099,2916,56720,713,9,679,138,2740,337,3629,1787,26893,486,3419
2020-12-26,5099,2916,57338,713,28,691,329,2979,344,3629,1826,27838,506,3670
2020-12-27,5099,2916,57419,713,18,714,237,3049,358,3629,1525,23870,519,3763
2020-12-28,5099,2916,56626,713,10,723,190,3177,354,3629,1994,30896,566,3900
2020-12-29,5099,2916,57009,713,24,744,373,3349,354,3629,1906,29616,634,4093
2020-12-30,5099,2916,56712,713,14,761,259,3369,353,3629,1924,29723,621,4130
2020-12-31,5099,2913,56432,712,8,757,190,3319,362,3625,1831,29001,620,4076
2021-01-01,5099,2913,56792,712,11,748,189,3286,363,3625,1833,29432,485,4034
2021-01-02,5099,2913,56837,712,35,763,348,3483,369,3625,1850,29520,489,4246
2021-01-03,5099,2913,56773,712,21,774,293,3600,350,3625,1543,24725,449,4374
2021-01-04,5099,2913,57163,712,19,804,310,3609,405,3625,1996,33738,675,4413
2021-01-05,5099,2913,57269,712,31,821,352,3682,419,3625,1960,32376,661,4503
2021-01-06,5099,2913,57344,712,20,819,284,3670,415,3625,2032,32159,658,4489
2021-01-07,5099,2913,57338,712,23,819,319,3684,424,3625,2071,34354,667,4503
2021-01-08,5099,2907,57332,713,17,831,269,3631,425,3620,1931,31611,652,4462
2021-01-09,5099,2907,57243,713,16,827,303,3686,443,3620,1557,26040,517,4513
2021-01-10,5099,2907,57251,713,20,836,268,3850,446,3620,1588,26109,502,4686
2021-01-11,5099,2907,57305,713,27,850,286,3883,447,3620,2030,33909,668,4733
2021-01-12,5100,2907,57147,713,21,859,321,3870,463,3620,2010,31862,680,4729
2021-01-13,5100,2907,57313,713,30,867,315,3856,467,3620,1992,31836,667,4723
2021-01-14,5100,2907,57234,713,21,858,309,3808,458,3620,2077,33911,700,4666
2021-01-15,5100,2915,57225,716,17,853,309,3720,454,3631,2012,31204,540,4573
2021-01-16,5100,2916,57102,716,16,845,220,3669,459,3632,1938,25638,503,4514
2021-01-17,5100,2916,57264,716,16,842,246,3732,471,3632,1607,26013,528,4574
2021-01-18,5114,2918,57322,716,15,843,249,3694,460,3634,2032,33781,677,4537
2021-01-19,5114,2918,57195,716,19,845,312,3581,466,3634,1942,31874,675,4426
2021-01-20,5114,2918,57314,716,24,829,298,3538,461,3634,1948,31894,651,4367
2021-01-21,5114,2918,56857,716,14,818,254,3457,462,3634,2043,33620,672,4275
2021-01-22,5114,2919,57234,719,24,845,261,3361,469,3638,1951,31429,558,4206
2021-01-23,5115,2919,57090,719,21,842,174,3233,463,3638,1919,26071,521,4075
2021-01-24,5115,2919,57193,719,21,842,194,3247,443,3638,1567,26033,482,4089
2021-01-25,5109,2913,57284,719,18,818,226,3184,463,3632,2010,33663,616,4002
2021-01-26,5108,2913,57062,719,22,822,207,3050,454,3632,1972,31948,634,3872
2021-01-27,5108,2913,57009,719,11,797,225,2982,442,3632,1952,31799,655,3779
2021-01-28,5108,2913,57025,719,16,806,212,2917,443,3632,1960,31001,656,3723
2021-01-29,5114,2924,57033,717,14,775,205,2754,390,3641,1927,31461,522,3529
2021-01-30,5100,2924,57149,717,10,769,164,2725,433,3641,1575,31248,500,3494
2021-01-31,5100,2924,57089,717,9,762,151,2712,430,3641,1551,26169,491,3474
2021-02-01,5104,2925,56744,717,9,734,169,2564,422,3642,2039,33945,641,3298
2021-02-02,5104,2925,57271,717,12,726,232,2600,424,3642,2011,32424,648,3326
2021-02-03,5341,3109,56697,717,14,706,176,2497,405,3826,2029,31737,669,3203
2021-02-04,5341,3109,56835,717,5,697,175,2403,390,3826,2142,34201,645,3100
2021-02-05,5372,3106,56917,720,11,681,166,2277,387,3826,2057,31749,558,2958
2021-02-06,5341,3106,56900,720,12,689,133,2207,388,3826,1660,26124,524,2896
2021-02-07,5368,3135,57086,720,13,684,168,2249,381,3855,1678,26139,487,2933
2021-02-08,5359,3120,57063,720,7,648,133,2186,369,3840,2126,34060,658,2834
2021-02-09,5359,3120,57290,720,13,642,144,2121,365,3840,2050,32469,654,2763
2021-02-10,5359,3120,57218,720,11,616,132,2002,347,3840,2066,32388,664,2618
2021-02-11,5359,3120,57211,720,10,595,138,1916,332,3840,2183,34464,661,2511
2021-02-12,5359,3119,56919,724,6,586,129,1839,334,3843,2072,31655,701,2425
2021-02-13,5359,3119,56982,724,7,573,114,1836,328,3843,1687,31332,573,2409
2021-02-14,5359,3119,56991,724,13,578,123,1829,323,3843,1656,26079,573,2407
2021-02-15,5359,3119,56642,724,9,570,100,1754,324,3843,1800,33552,555,2324
2021-02-16,5359,3119,57143,724,17,586,112,1795,336,3843,2059,32457,675,2381
2021-02-17,5359,3119,57056,724,14,553,149,1736,315,3843,2070,32685,693,2289
2021-02-18,5359,3119,57244,724,10,539,153,1732,307,3843,2187,34790,714,2271
2021-02-19,5359,3120,57243,733,12,524,134,1678,299,3853,2077,32125,683,2202
2021-02-20,5223,3009,57133,733,10,544,125,1633,302,3742,2046,32087,506,2177
2021-02-21,5223,3009,57192,733,11,547,134,1693,304,3742,1666,26610,521,2240
2021-02-22,5223,3009,57277,733,12,552,113,1632,310,3742,2170,34929,667,2184
2021-02-23,5223,3009,57288,821,14,573,143,1611,306,3830,2133,33130,683,2184
2021-02-24,5223,3009,57262,821,14,556,135,1567,302,3830,2087,33117,667,2123
2021-02-25,5223,3009,57345,821,14,552,134,1552,301,3830,2203,35237,726,2104
2021-02-26,5222,3008,57300,820,10,536,145,1499,289,3828,2107,32510,705,2035
2021-02-27,5222,3008,56682,820,13,551,113,1496,286,3828,2091,31703,541,2047
2021-02-28,5222,3008,57248,820,12,546,114,1507,276,3828,1701,26950,543,2053
2021-03-01,5222,3008,57358,820,14,559,131,1470,291,3828,2193,35086,681,2029
2021-03-02,5222,3008,57380,820,13,540,150,1458,288,3828,2120,33100,695,1998
2021-03-03,5222,3008,57276,820,11,538,131,1460,285,3828,2097,33022,717,1998
2021-03-04,5222,3008,57380,820,13,527,134,1440,287,3828,2203,35078,721,1967
2021-03-05,5222,3008,57280,818,11,522,135,1438,290,3826,2108,32244,708,1960
2021-03-06,5231,3017,57222,818,10,514,116,1445,287,3835,2040,32113,548,1959
2021-03-07,5231,3017,57244,818,10,524,111,1478,290,3835,1660,26820,529,2002
2021-03-08,5231,3017,57315,818,13,531,133,1404,287,3835,2174,34905,648,1935
2021-03-09,5231,3017,57333,818,9,526,150,1475,284,3835,2113,33014,675,2001
2021-03-10,5231,3017,57269,818,10,519,141,1444,288,3835,2129,33071,712,1963
2021-03-11,5231,3017,57259,818,6,519,141,1461,299,3835,2201,35094,707,1980
2021-03-12,5231,3017,57227,818,9,510,158,1454,287,3835,2063,32227,672,1964
2021-03-13,5261,3053,57018,819,8,513,294,1492,295,3872,2039,31885,511,2005
2021-03-14,5261,3053,56904,819,7,535,147,1549,294,3872,1692,26526,504,2084
2021-03-15,5261,3053,57259,819,7,528,136,1527,295,3872,2112,35050,701,2055
2021-03-16,5266,3058,57168,819,22,559,163,1495,291,3877,2062,32699,697,2054
2021-03-17,5266,3058,57193,819,10,553,162,1529,290,3877,2071,32592,667,2082
2021-03-18,5266,3058,57087,819,18,561,171,1534,271,3877,2170,34594,725,2095
2021-03-19,5262,3058,56858,820,15,553,199,1575,296,3878,2052,31568,708,2128
2021-03-20,5262,3058,57120,820,12,557,123,1610,295,3878,2014,31471,552,2167
2021-03-21,5262,3058,57076,820,14,564,138,1616,299,3878,1686,26323,525,2180
2021-03-22,5262,3058,57186,820,8,594,211,1675,312,3878,2152,34598,660,2269
2021-03-23,5262,3058,57255,820,14,612,180,1651,337,3878,2034,32754,658,2263
2021-03-24,5262,3058,57148,820,14,617,179,1654,327,3878,2061,32738,634,2271
2021-03-25,5277,3058,57230,820,8,643,190,1700,337,3878,2208,34887,662,2343
2021-03-26,5277,3058,56960,823,14,653,151,1675,316,3881,1979,31918,511,2328
2021-03-27,5277,3058,57075,823,13,653,133,1707,340,3881,1972,31749,496,2360
2021-03-28,5277,3058,57058,823,12,671,158,1759,357,3881,1614,26638,505,2430
2021-03-29,5277,3058,57197,823,16,680,172,1809,372,3881,2075,34720,640,2489
2021-03-30,5277,3058,57131,823,9,690,194,1805,376,3881,1998,32683,641,2495
2021-03-31,5277,3058,56985,823,15,694,217,1831,368,3881,1984,32483,550,2525
2021-04-01,5277,3058,56879,823,17,699,228,1841,379,3881,1997,31720,640,2540
2021-04-02,5277,3067,56903,832,13,731,220,1904,371,3899,1918,31062,513,2635
2021-04-03,5283,3067,56842,832,16,768,222,1945,377,3899,1891,30885,456,2713
2021-04-04,5283,3067,56852,832,17,796,192,1999,409,3899,1549,25852,498,2795
2021-04-05,5283,3067,57241,832,11,812,238,2082,435,3899,1934,33926,500,2894
2021-04-06,5283,3067,57205,832,15,812,260,2128,444,3899,1911,32272,598,2940
2021-04-07,5284,3068,57196,832,26,855,283,2149,463,3900,1894,32588,629,3004
2021-04-08,5284,3068,57236,832,20,878,278,2185,490,3900,2007,34964,615,3063
2021-04-09,5284,3075,56967,828,17,919,307,2248,529,3903,1871,31801,638,3167
2021-04-10,5265,3056,56410,828,30,955,309,2374,519,3884,1845,31150,507,3329
2021-04-11,5265,3056,57117,828,24,973,350,2489,557,3884,1494,26258,487,3462
2021-04-12,5265,3056,57222,847,28,987,342,2593,566,3903,1930,33982,631,3580
2021-04-13,5265,3056,57285,847,23,1004,325,2676,593,3903,1828,31878,643,3680
2021-04-14,5265,3056,56991,847,34,1029,327,2692,600,3903,1793,31643,631,3721
2021-04-15,5270,3056,57206,847,35,1084,366,2766,643,3903,1860,33862,634,3850
2021-04-16,5270,3053,57162,847,18,1113,411,2895,658,3900,1770,30824,637,4008
2021-04-17,5263,3046,57010,847,24,1145,345,2956,669,3893,1719,30655,479,4101
2021-04-18,5271,3054,57157,847,21,1175,333,3043,688,3901,1690,30762,478,4218
2021-04-19,5271,3054,57186,847,14,1172,361,3048,710,3901,1782,32770,613,4220
2021-04-20,5271,3054,57221,846,26,1210,414,3113,745,3900,1733,31051,621,4323
2021-04-21,5273,3054,56338,846,30,1244,369,3071,765,3900,1699,30480,588,4315
2021-04-22,5276,3054,56949,846,17,1260,321,3048,761,3900,1746,32651,597,4308
2021-04-23,5277,3075,56773,842,20,1286,337,2995,763,3917,1666,29847,586,4281
2021-04-24,5314,3093,56782,842,17,1294,330,3051,764,3935,1675,29968,442,4345
2021-04-25,5314,3093,56777,842,27,1319,297,3066,767,3935,1618,30252,446,4385
2021-04-26,5314,3093,57106,842,19,1320,318,3039,750,3935,1731,32711,597,4359
2021-04-27,5314,3093,57098,842,20,1321,333,3009,763,3935,1685,30701,608,4330
2021-04-28,5263,3093,57360,842,18,1338,343,2905,783,3935,1660,30480,592,4243
2021-04-29,5253,3093,57211,842,21,1343,325,2853,798,3935,1741,32635,591,4196
2021-04-30,5252,3137,57261,846,16,1348,336,2801,793,3983,1643,29964,574,4149
2021-05-01,5468,3349,57031,846,22,1349,312,2852,780,4195,1606,30024,452,4201
2021-05-02,5468,3349,57043,846,18,1343,291,2910,766,4195,1624,30298,444,4253
2021-05-03,5468,3349,57141,846,21,1345,305,2811,778,4195,1767,32591,493,4156
2021-05-04,5468,3349,57149,846,15,1334,317,2718,792,4195,1719,30635,631,4052
2021-05-05,5472,3354,57178,846,16,1307,283,2687,785,4200,1685,30581,615,3994
2021-05-06,5473,3355,57145,846,23,1279,270,2593,787,4201,1797,32667,646,3872
2021-05-07,5473,3364,56656,850,23,1269,296,2516,763,4214,1694,29590,601,3785
2021-05-08,5473,3364,56559,850,12,1259,266,2507,748,4214,1395,24496,467,3766
2021-05-09,5473,3364,56601,850,13,1246,236,2577,718,4214,1417,24987,455,3823
2021-05-10,5481,3372,57100,850,22,1244,234,2475,735,4222,1821,32615,636,3719
2021-05-11,5481,3372,56928,850,22,1221,252,2507,724,4222,1723,30703,635,3728
2021-05-12,5481,3372,57047,850,12,1225,217,2438,743,4222,1713,28859,614,3663
2021-05-13,5481,3372,57052,850,21,1232,251,2417,750,4222,1807,30808,634,3649
2021-05-14,5478,3376,56977,850,13,1233,178,2224,737,4226,1705,28325,603,3457
2021-05-15,5478,3376,56621,850,12,1242,190,2235,734,4226,1367,22901,475,3477
2021-05-16,5478,3376,56997,850,9,1232,179,2304,709,4226,1400,23390,469,3536
2021-05-17,5478,3376,56943,850,10,1220,167,2199,735,4226,1839,31258,681,3419
2021-05-18,5478,3376,57020,850,11,1168,220,2163,688,4226,1811,31037,698,3331
2021-05-19,5480,3378,56926,850,16,1135,215,2124,636,4228,1846,31016,672,3259
2021-05-20,5480,3378,56982,850,7,1114,203,2025,656,4228,1978,33018,717,3139
2021-05-21,5483,3385,56966,852,23,1090,202,2032,641,4237,1880,30131,686,3122
2021-05-22,5483,3385,56913,852,14,1062,169,1923,610,4237,1852,30046,504,2985
2021-05-23,5483,3385,56879,852,6,1053,197,1964,595,4237,1847,30280,522,3017
2021-05-24,5483,3385,56550,852,15,1047,177,1905,602,4237,1956,32483,569,2952
2021-05-25,5483,3385,57012,852,23,1030,198,1838,580,4237,1884,31370,704,2868
2021-05-26,5483,3384,56980,848,21,1001,172,1786,573,4232,1920,31589,702,2787
2021-05-27,5483,3384,56509,848,15,973,146,1682,567,4232,2008,33653,737,2655
2021-05-28,5485,3384,56835,848,20,933,151,1577,539,4232,1915,30747,719,2510
2021-05-29,5485,3384,57499,848,7,913,108,1541,515,4232,1486,23829,500,2454
2021-05-30,5485,3384,56468,848,19,912,121,1488,493,4232,1915,25479,546,2400
2021-05-31,5485,3384,56644,848,13,871,120,1419,492,4232,2042,33562,712,2290
2021-06-01,5485,3384,56625,848,13,846,116,1397,502,4232,1967,31507,685,2243
2021-06-02,5485,3384,56577,848,10,788,116,1333,461,4232,1958,31299,705,2121
2021-06-03,5490,3389,56743,848,7,748,122,1251,459,4237,1969,31292,703,1999
2021-06-04,5490,3384,56627,847,6,720,112,1216,450,4231,1990,30670,711,1936
2021-06-05,5490,3384,58066,847,11,705,116,1220,436,4231,1574,30453,514,1925
2021-06-06,5490,3384,57696,847,9,687,120,1201,428,4231,1648,33386,539,1888
2021-06-07,5490,3384,57115,847,13,669,105,1160,393,4231,1963,31589,522,1829
2021-06-08,5490,3384,57013,847,10,656,92,1091,401,4231,1991,31966,690,1747
2021-06-09,5490,3384,57083,847,13,636,111,1040,390,4231,1986,32024,672,1676
2021-06-10,5490,3384,56991,847,7,621,99,966,381,4231,2081,34122,556,1587
2021-06-11,5489,3387,56835,848,14,589,102,924,360,4235,1999,31141,664,1513
2021-06-12,5490,3388,56298,848,5,590,99,913,355,4236,1941,30492,620,1503
2021-06-13,5490,3388,56272,848,6,574,84,893,344,4236,1913,30883,629,1467
2021-06-14,5490,3388,56410,848,9,544,71,905,327,4236,2078,33592,667,1449
2021-06-15,5490,3388,56381,848,6,527,85,848,317,4236,2012,31837,674,1375
2021-06-16,5490,3388,56024,848,5,502,67,794,309,4236,2004,31597,622,1296
2021-06-17,5490,3388,55897,848,11,499,87,738,304,4236,2017,31439,621,1237
2021-06-18,5490,3383,55989,848,12,482,79,702,306,4231,2069,32712,674,1184
2021-06-19,5490,3383,56401,848,10,479,81,671,288,4231,1576,30689,419,1150
2021-06-20,5490,3383,56991,848,5,469,72,699,278,4231,1595,31121,434,1168
2021-06-21,5490,3383,56294,848,10,460,55,631,272,4231,2008,31806,642,1091
2021-06-22,5490,3383,56542,848,4,448,60,606,264,4231,2118,34215,651,1054
2021-06-23,5490,3383,56324,848,4,437,65,575,264,4231,2036,31943,637,1012
2021-06-24,5490,3383,56370,848,6,406,54,584,264,4231,2037,31927,644,990
2021-06-25,5490,3383,55953,848,7,400,66,545,243,4231,2127,33012,510,945
2021-06-26,5490,3383,56095,848,2,396,70,532,248,4231,1973,25393,472,928
2021-06-27,5490,3383,55773,848,3,382,53,543,236,4231,1973,25485,498,925
2021-06-28,5490,3383,56325,848,3,364,59,540,231,4231,2054,31597,664,904
2021-06-29,5490,3383,56167,848,7,362,56,502,226,4231,2226,34439,715,864
2021-06-30,5490,3383,55665,848,4,346,74,483,218,4231,2110,31624,711,829
2021-07-01,5490,3383,55816,848,4,335,68,448,200,4231,1677,25572,517,783
2021-07-02,5490,3383,55846,848,5,319,45,442,204,4231,1646,25323,515,761
2021-07-03,5488,3381,55902,848,3,300,43,443,194,4229,1660,25650,495,743
2021-07-04,5488,3381,55609,848,2,295,41,446,189,4229,1699,25427,481,741
2021-07-05,5488,3381,55914,852,4,291,54,444,189,4233,2168,32179,709,735
2021-07-06,5488,3381,56298,852,3,278,52,450,183,4233,2274,34847,736,728
2021-07-07,5488,3381,56306,852,0,267,56,441,176,4233,2155,32699,708,708
2021-07-08,5488,3381,56176,852,5,263,46,389,175,4233,2155,32517,684,652
2021-07-09,5488,3385,55499,861,2,259,54,371,168,4246,2100,31395,665,630
2021-07-10,5488,3385,55382,861,3,262,54,381,166,4246,2044,31151,494,643
2021-07-11,5488,3385,56137,861,3,266,30,364,154,4246,2101,31935,506,630
2021-07-12,5488,3385,56306,861,5,250,40,370,154,4246,2096,32450,640,620
2021-07-13,5488,3385,56857,861,4,239,56,363,147,4246,2163,33392,672,602
2021-07-14,5488,3385,56900,861,1,228,54,359,144,4246,2271,35437,690,587
2021-07-15,5488,3385,56841,861,4,215,43,355,143,4246,2140,33018,674,570
2021-07-16,5488,3384,56663,867,4,202,37,334,138,4251,2101,32291,652,536
2021-07-17,5488,3384,55855,867,3,199,49,342,127,4251,1716,31842,507,541
2021-07-18,5488,3384,55963,867,3,200,38,346,122,4251,1693,31968,501,546
2021-07-19,5488,3384,56426,867,2,195,45,327,124,4251,2138,32502,690,522
2021-07-20,5488,3384,56846,867,7,203,38,305,103,4251,2147,33044,647,508
2021-07-21,5488,3384,56856,867,1,203,44,294,114,4251,2244,35202,683,497
2021-07-22,5488,3384,56604,867,0,198,42,279,111,4251,2109,32705,558,477
2021-07-23,5488,3379,56273,864,3,185,41,258,109,4243,2105,31921,686,443
2021-07-24,5488,3379,56463,864,2,177,39,264,109,4243,2090,32005,508,441
2021-07-25,5488,3379,56693,864,6,180,42,280,104,4243,2058,32294,521,460
2021-07-26,5316,3222,56931,864,4,178,41,277,108,4086,2144,32717,698,455
2021-07-27,5316,3222,56932,864,7,173,45,265,109,4086,2170,33078,712,438
2021-07-28,5316,3226,57240,871,3,178,50,272,109,4097,2269,35213,683,450
2021-07-29,5316,3226,56873,871,3,173,46,274,110,4097,2113,32800,677,447
2021-07-30,5316,3226,56712,871,2,161,45,276,114,4097,2087,31992,657,437
2021-07-31,5316,3226,56787,871,1,150,43,275,105,4097,2057,31472,524,425
2021-08-01,5316,3226,56803,871,0,152,36,280,101,4097,2066,31692,517,432
2021-08-02,5316,3226,56654,871,5,157,30,281,100,4097,2110,32195,517,438
2021-08-03,5316,3226,56431,871,1,159,30,288,97,4097,2138,32526,587,447
2021-08-04,5317,3227,56594,871,5,162,59,293,98,4098,2260,35091,724,455
2021-08-05,5317,3227,56520,871,4,161,67,325,97,4098,2136,32736,710,486
2021-08-06,5317,3227,55691,871,5,165,62,290,99,4098,2095,31599,723,455
2021-08-07,5317,3227,56680,871,1,163,64,305,93,4098,1725,26272,534,468
2021-08-08,5317,3227,56428,871,4,160,49,293,90,4098,1727,26274,531,453
2021-08-09,5317,3222,56144,872,3,163,51,323,91,4094,2135,32534,706,486
2021-08-10,5317,3222,57092,872,10,171,57,327,95,4094,2139,33336,719,498
2021-08-11,5317,3222,56578,872,12,191,90,331,98,4094,2254,35248,765,522
2021-08-12,5317,3222,56808,872,4,192,66,353,93,4094,2098,33294,746,545
2021-08-13,5317,3221,56732,869,10,202,71,362,93,4090,2091,32287,730,564
2021-08-14,5317,3221,56781,869,6,210,73,345,97,4090,1734,26471,570,555
2021-08-15,5317,3221,56968,869,7,215,59,362,98,4090,1725,26945,551,577
2021-08-16,5317,3221,56476,869,7,230,71,403,110,4090,2142,33111,741,633
2021-08-17,5317,3221,56667,869,4,237,69,412,108,4090,2127,33161,765,649
2021-08-18,5317,3221,56973,869,11,240,84,450,103,4090,2203,35528,743,690
2021-08-19,5314,3221,57003,869,10,253,73,485,111,4090,2090,33307,717,738
2021-08-20,5314,3229,56533,868,7,256,76,530,115,4097,2065,32397,728,786
2021-08-21,4586,2538,49801,511,3,209,76,480,88,3049,1695,26676,531,689
2021-08-22,4586,2538,49883,511,4,224,61,525,91,3049,1677,26789,543,749
2021-08-23,4586,2538,49428,511,4,230,53,523,98,3049,1716,27199,576,753
2021-08-24,5314,3229,56711,868,10,319,103,622,140,4097,2112,33479,721,941
2021-08-25,5314,3229,56699,868,16,331,86,649,138,4097,2175,35571,748,980
2021-08-26,5308,3229,56682,868,13,346,112,710,138,4097,2091,33087,714,1056
2021-08-27,5308,3224,56387,847,13,362,95,723,141,4071,2072,32239,715,1085
2021-08-28,5308,3224,55809,847,8,361,95,732,154,4071,2045,26189,536,1093
2021-08-29,5308,3224,56352,847,6,375,78,744,151,4071,2046,26972,530,1119
2021-08-30,5308,3224,56708,847,10,384,120,791,153,4071,2049,32835,637,1175
2021-08-31,5308,3224,56505,868,19,404,124,803,169,4092,2114,33195,753,1207
2021-09-01,5308,3224,56662,868,15,419,136,821,188,4092,2164,35447,773,1240
2021-09-02,5308,3224,56115,868,21,445,120,822,196,4092,2081,32895,717,1267
2021-09-03,5308,3227,56513,866,19,459,111,891,197,4093,2006,32361,627,1350
2021-09-04,5308,3227,56391,866,11,473,123,925,203,4093,2013,26347,570,1398
2021-09-05,5308,3227,56079,866,19,493,114,942,213,4093,1991,26331,554,1435
2021-09-06,5308,3227,56706,866,15,512,131,962,216,4093,2017,27235,582,1474
2021-09-07,5308,3227,56259,866,15,527,105,1022,218,4093,2141,32919,740,1549
2021-09-08,5308,3227,56401,866,26,537,146,1073,227,4093,2238,35553,852,1610
2021-09-09,5312,3227,56467,866,13,547,123,1088,232,4093,2121,33485,714,1635
2021-09-10,5312,3228,56583,867,15,568,122,1158,241,4095,2103,33170,694,1726
2021-09-11,2930,1595,37032,867,11,419,75,960,138,2462,535,15464,52,1379
2021-09-12,5312,3228,56686,867,13,599,122,1197,238,4095,2038,33213,538,1796
2021-09-13,5312,3228,56839,867,18,616,106,1166,242,4095,2128,33653,645,1782
2021-09-14,5312,3228,56895,867,18,633,140,1244,251,4095,2211,36346,695,1877
2021-09-15,5312,3228,56809,867,17,635,111,1258,254,4095,2217,36230,823,1893
2021-09-16,5313,3228,56814,867,18,636,120,1268,268,4095,2222,35891,757,1904
2021-09-17,5315,3231,56757,869,17,624,119,1298,251,4100,2178,35258,834,1922
2021-09-18,4587,2538,49838,511,9,475,78,1167,172,3049,1723,27295,549,1642
2021-09-19,4587,2538,49886,511,10,489,63,1192,169,3049,1761,27524,533,1681
2021-09-20,5315,3231,56855,869,17,652,120,1353,280,4100,2166,35820,812,2005
2021-09-21,5289,3207,56890,869,19,674,139,1424,280,4076,2169,36058,808,2098
2021-09-22,5289,3207,56433,869,18,678,140,1447,291,4076,2164,36010,829,2125
2021-09-23,5289,3207,56785,869,20,685,173,1477,286,4076,2162,35899,592,2162
2021-09-24,5289,3209,56807,871,13,682,115,1463,283,4080,2054,33061,763,2145
2021-09-25,4561,2514,49577,511,8,536,62,1241,184,3025,1703,27126,535,1777
2021-09-26,4561,2514,50060,511,9,553,58,1275,189,3025,1705,27535,543,1828
2021-09-27,5289,3209,56864,871,16,690,131,1496,284,4080,2176,35683,790,2186
2021-09-28,5289,3209,56845,871,13,691,160,1501,275,4080,2225,35986,814,2192
2021-09-29,5289,3209,56776,871,19,696,150,1493,266,4080,2221,36002,844,2189
2021-09-30,4561,2514,49520,511,10,538,94,1293,180,3025,1900,29760,644,1831
2021-10-01,5289,3208,55460,871,9,672,111,1479,263,4079,2175,33794,811,2151
2021-10-02,4561,2514,49909,511,9,533,68,1307,176,3025,1836,28916,580,1840
2021-10-03,4561,2514,49555,511,6,531,67,1309,177,3025,1845,28692,574,1840
2021-10-04,5289,3208,56365,871,19,670,114,1534,256,4079,2238,34849,827,2204
2021-10-05,5289,3208,56796,871,16,670,195,1539,254,4079,2296,36278,772,2209
2021-10-06,5289,3208,56838,871,13,650,144,1571,251,4079,2288,36337,865,2221
2021-10-07,5289,3208,56760,871,12,651,167,1594,250,4079,2250,35864,869,2245
2021-10-08,5289,3201,56552,871,10,650,136,1557,247,4072,2246,35565,866,2207
2021-10-09,5289,3201,56019,871,15,638,112,1505,252,4072,1861,28651,598,2143
2021-10-10,5289,3201,56049,871,6,636,96,1524,248,4072,1835,28564,580,2160
2021-10-11,5289,3201,56773,871,12,616,123,1535,246,4072,1851,29227,577,2151
2021-10-12,5289,3200,56673,871,17,638,111,1511,264,4071,2233,35451,885,2149
2021-10-13,5289,3201,56954,871,9,634,146,1535,265,4072,2294,36872,886,2169
2021-10-14,5289,3201,57361,871,20,638,135,1493,276,4072,2284,36899,800,2131
2021-10-15,5250,3180,57048,874,9,630,130,1507,274,4054,2261,36611,787,2137
2021-10-16,5250,3180,57284,874,10,622,99,1464,265,4054,2217,35743,611,2086
2021-10-17,5250,3180,57251,874,15,631,109,1478,270,4054,2233,35211,583,2109
2021-10-18,5250,3180,57210,874,14,618,149,1469,269,4054,2258,35990,753,2087
2021-10-19,5237,3170,57453,874,9,593,108,1479,275,4044,2318,36684,778,2072
2021-10-20,5237,3170,57211,874,16,592,116,1426,268,4044,2282,36869,769,2018
2021-10-21,5237,3170,56399,874,15,562,110,1432,242,4044,2193,33460,754,1994
2021-10-22,5237,3170,56456,871,17,553,113,1379,245,4041,2127,33714,766,1932
2021-10-23,5237,3170,56432,871,9,557,117,1333,244,4041,2103,32922,574,1890
2021-10-24,5237,3170,56068,871,10,549,104,1323,243,4041,2109,32335,572,1872
2021-10-25,5237,3170,56605,871,14,545,93,1305,239,4041,2243,35288,759,1850
2021-10-26,5237,3170,57065,871,25,546,121,1272,245,4041,2299,36430,779,1818
2021-10-27,5237,3170,57025,871,24,556,134,1274,253,4041,2279,36465,775,1830
2021-10-28,5237,3170,57320,871,18,548,118,1276,241,4041,2289,36698,665,1824
2021-10-29,5237,3171,56871,871,15,546,105,1245,242,4042,2196,34930,747,1791
2021-10-30,5237,3171,56937,871,14,532,97,1218,244,4042,2150,28283,546,1750
2021-10-31,5237,3171,56433,871,13,522,113,1241,233,4042,2120,27937,524,1763
2021-11-01,5237,3171,56982,873,19,523,91,1268,230,4044,2158,34230,748,1791
2021-11-02,5237,3171,57010,873,13,515,106,1322,232,4044,2200,35185,745,1837
2021-11-03,5237,3171,56037,873,15,492,123,1236,241,4044,2190,34295,732,1728
2021-11-04,5237,3171,56952,873,13,475,140,1242,235,4044,2190,35498,770,1717
2021-11-05,5237,3169,56730,877,9,466,111,1242,224,4046,2177,34815,739,1708
2021-11-06,5237,3169,56957,877,7,454,98,1243,217,4046,2179,34216,528,1697
2021-11-07,5237,3169,56646,877,11,449,102,1256,214,4046,2133,34037,545,1705
2021-11-08,5237,3169,55305,875,9,443,105,1234,215,4044,2216,33824,693,1677
2021-11-09,5237,3169,56241,875,14,448,97,1231,220,4044,2241,34733,751,1679
2021-11-10,5237,3169,56981,875,12,430,115,1152,216,4044,2220,35301,749,1582
2021-11-11,5237,3169,56284,875,9,414,108,1184,215,4044,2233,34224,561,1598
2021-11-12,5237,3167,55733,878,15,417,112,1173,208,4045,2206,33549,731,1590
2021-11-13,5237,3167,56674,878,13,416,124,1174,204,4045,2165,33610,526,1590
2021-11-14,5237,3167,56020,878,10,421,85,1184,212,4045,2184,32854,527,1605
2021-11-15,5237,3167,56443,878,13,425,94,1161,210,4045,2187,34183,728,1586
2021-11-16,5237,3167,56993,878,8,407,116,1189,202,4045,2223,34824,738,1596
2021-11-17,5237,3167,56774,878,12,403,104,1171,201,4045,2216,34827,706,1574
2021-11-18,5237,3167,57079,878,12,406,120,1164,205,4045,2203,34818,728,1570
2021-11-19,5236,3160,56033,874,11,407,111,1136,209,4034,2206,34242,716,1543
2021-11-20,5235,3160,56254,874,8,406,109,1116,210,4034,2178,34275,555,1522
2021-11-21,5235,3160,56314,874,16,419,93,1129,207,4034,2162,33419,518,1548
2021-11-22,5235,3160,55988,874,7,412,118,1128,210,4034,2218,34256,735,1540
2021-11-23,5235,3160,56640,874,13,424,108,1107,214,4034,2264,35812,738,1531
2021-11-24,5235,3160,55326,874,9,414,101,1093,198,4034,2251,34696,741,1507
2021-11-25,5235,3160,56461,874,9,411,101,1024,205,4034,2262,35693,757,1435
2021-11-26,5235,3162,56452,875,13,406,105,1033,206,4037,2232,35090,762,1439
2021-11-27,5235,3162,55724,875,15,395,106,1056,205,4037,2092,31943,570,1451
2021-11-28,5235,3162,55756,875,7,404,88,1046,207,4037,2101,30802,587,1450
2021-11-29,5235,3162,56108,875,18,430,101,1071,212,4037,2169,34076,743,1501
2021-11-30,5235,3162,56145,875,4,420,76,1089,204,4037,2314,33445,734,1509
2021-12-01,5235,3162,56082,875,10,408,110,1081,204,4037,2275,33429,728,1489
2021-12-02,5235,3162,56022,875,11,400,93,1042,207,4037,2272,35140,710,1442
2021-12-03,5198,3160,55930,873,16,419,118,987,210,4033,2303,34914,714,1406
2021-12-04,5198,3160,55012,873,7,411,100,991,209,4033,2214,31320,551,1402
2021-12-05,5198,3160,55137,873,4,422,63,1027,212,4033,2146,29513,514,1449
2021-12-06,5198,3160,56206,873,13,416,118,1015,211,4033,2314,34940,714,1431
2021-12-07,5198,3160,56871,873,15,395,101,1022,214,4033,2366,36170,742,1417
2021-12-08,5198,3160,56343,873,12,399,111,1003,209,4033,2400,35787,768,1402
2021-12-09,5198,3160,56860,873,17,395,108,1006,204,4033,2397,36189,811,1401
2021-12-10,5198,3163,56706,871,15,390,114,1002,201,4034,2350,35560,763,1392
2021-12-11,5198,3163,56521,871,11,394,114,1020,197,4034,2258,32520,533,1414
2021-12-12,5198,3163,56368,871,15,409,101,1035,192,4034,2250,32139,504,1444
2021-12-13,5198,3163,55712,871,13,418,100,1010,211,4034,2320,34391,718,1428
2021-12-14,5198,3163,55842,871,11,418,135,990,216,4034,2342,35221,752,1408
2021-12-15,5206,3171,55562,871,11,407,122,1024,220,4042,2363,34877,785,1431
2021-12-16,5206,3171,56274,871,14,389,139,1052,203,4042,2363,35437,750,1441
2021-12-17,5210,3172,56060,872,16,402,157,1064,205,4044,2356,34829,748,1466
2021-12-18,5210,3172,55322,872,22,421,135,1063,218,4044,2223,31047,558,1484
2021-12-19,5210,3172,55575,872,15,426,137,1123,221,4044,2193,30781,548,1549
2021-12-20,5210,3172,56195,768,12,436,148,1132,221,3940,2328,35019,799,1568
2021-12-21,5212,3174,55899,768,14,432,183,1180,229,3942,2358,34865,821,1612
2021-12-22,5212,3174,55787,768,14,425,209,1278,220,3942,2330,33636,774,1703
2021-12-23,5213,3174,55882,768,17,432,221,1279,226,3942,2240,33649,793,1711
2021-12-24,5213,3174,55732,768,10,422,147,1327,213,3942,2138,31902,787,1749
2021-12-25,5213,3174,55522,768,10,420,126,1376,210,3942,2028,28401,552,1796
2021-12-26,5213,3174,55583,768,34,447,386,1633,211,3942,2087,30867,550,2080
2021-12-27,5213,3174,55611,768,21,461,310,1863,220,3942,2143,31694,591,2324
2021-12-28,5213,3174,56340,768,20,460,371,2091,222,3942,2152,33004,553,2551
2021-12-29,5213,3174,56295,768,34,495,516,2421,227,3942,2199,33357,784,2916
2021-12-30,5214,3175,55498,767,32,519,526,2763,233,3942,2241,33024,780,3282
2021-12-31,5213,3174,55117,768,28,538,488,2721,252,3942,2227,32349,767,3259
2022-01-01,5213,3174,55427,768,25,562,444,3223,252,3942,2159,30142,553,3785
2022-01-02,5213,3174,55078,768,44,607,590,3587,278,3942,2225,32002,565,4194
2022-01-03,5213,3174,55367,768,29,633,700,4045,288,3942,2207,32587,552,4678
2022-01-04,5213,3170,56434,767,38,693,667,4532,316,3937,2269,34251,795,5225
2022-01-05,5214,3171,55908,767,48,726,806,4947,345,3938,2152,33889,816,5673
2022-01-06,5214,3171,55924,767,49,779,869,5251,361,3938,2232,33457,778,6030
2022-01-07,5213,3169,55676,763,36,854,915,5783,394,3932,2166,33273,755,6637
2022-01-08,5213,3169,56141,763,37,892,806,6182,395,3932,2116,32967,551,7074
2022-01-09,5213,3169,56034,763,21,903,819,6442,400,3932,2084,32738,529,7345
2022-01-10,5213,3169,56244,763,46,962,907,7006,418,3932,2089,33137,747,7968
2022-01-11,5213,3169,56045,763,40,1010,1039,7418,433,3932,2101,32983,762,8428
2022-01-12,5213,3169,56443,763,46,1020,1016,7834,454,3932,2108,33065,742,8854
2022-01-13,5213,3169,56020,763,42,1056,1037,8161,471,3932,2077,32278,754,9217
2022-01-14,5213,3170,55886,762,38,1085,999,8411,514,3932,2035,32070,752,9496
2022-01-15,5213,3170,56367,762,49,1110,1014,8751,538,3932,1998,32034,535,9861
2022-01-16,5213,3170,56366,762,39,1113,829,9021,554,3932,1961,31764,531,10134
2022-01-17,5213,3170,55830,762,42,1167,794,9253,564,3932,1969,31379,726,10420
2022-01-18,5213,3170,56385,762,49,1182,893,9216,573,3932,2017,32629,686,10398
2022-01-19,5213,3170,56496,762,52,1194,965,9349,573,3932,2024,32435,699,10543
2022-01-20,5213,3170,56427,762,36,1174,913,9330,587,3932,2016,32561,662,10504
2022-01-21,5222,3176,56566,767,47,1190,876,9245,611,3943,2005,32596,698,10435
2022-01-22,5222,3176,56243,767,31,1184,778,9273,605,3943,1999,31640,523,10457
2022-01-23,5222,3176,56414,767,41,1182,726,9438,601,3943,1952,31717,500,10620
2022-01-24,5222,3176,56583,767,39,1204,731,9555,613,3943,2009,32380,688,10759
2022-01-25,5222,3176,56501,767,37,1159,775,9283,618,3943,2033,33011,694,10442
2022-01-26,5227,3176,56320,767,25,1126,704,9113,588,3943,2046,32828,686,10239
2022-01-27,5227,3176,56260,767,39,1137,779,8983,609,3943,2041,32623,709,10120
2022-01-28,5227,3176,56602,766,45,1134,758,8606,605,3942,1988,33107,712,9740
2022-01-29,5227,3176,55711,766,33,1109,586,8473,566,3942,1955,31503,542,9582
2022-01-30,5227,3176,55690,766,27,1107,530,8534,556,3942,1950,31483,486,9641
2022-01-31,5227,3176,56504,766,31,1102,610,8486,555,3942,1990,32713,691,9588
2022-02-01,5227,3176,56491,766,32,1060,650,8273,536,3942,2046,33511,684,9333
2022-02-02,5227,3176,56183,766,32,1033,606,7985,539,3942,2037,33598,718,9018
2022-02-03,5228,3177,55789,766,31,1017,639,7758,511,3943,2059,33060,717,8775
2022-02-04,5228,3174,55832,768,38,1000,549,7449,492,3942,2048,32979,899,8449
2022-02-05,5228,3174,56313,768,30,969,498,7260,483,3942,2087,32796,561,8229
2022-02-06,5228,3174,55878,768,25,973,434,7270,483,3942,2033,32340,524,8243
2022-02-07,5228,3174,56102,768,28,976,455,7193,498,3942,2091,33324,927,8169
2022-02-08,5228,3174,55461,768,30,944,565,7010,482,3942,2075,33225,909,7954
2022-02-09,5228,3174,55176,768,26,930,542,6791,480,3942,2099,33152,729,7721
2022-02-10,5228,3174,56289,768,30,894,494,6520,451,3942,2129,34155,730,7414
2022-02-11,5228,3189,55807,769,30,848,434,6258,427,3958,2136,33788,751,7106
2022-02-12,5228,3189,54968,769,23,820,394,6041,401,3958,2118,32229,546,6861
2022-02-13,5228,3189,55553,769,18,813,313,6132,390,3958,2031,31507,526,6945
2022-02-14,5228,3189,56214,769,17,779,395,5988,384,3958,2120,34484,702,6767
2022-02-15,5228,3189,56352,769,20,754,381,5793,382,3958,2136,35029,706,6547
2022-02-16,5228,3189,56557,769,21,734,425,5613,371,3958,2175,35076,715,6347
2022-02-17,5228,3192,56225,773,26,727,393,5422,359,3965,2082,34701,689,6149
2022-02-18,5228,3192,56129,773,15,697,350,5242,349,3965,2088,34683,556,5939
2022-02-19,5228,3192,56178,773,24,661,353,5134,334,3965,2017,31392,526,5795
2022-02-20,5228,3192,56267,773,19,647,292,5176,334,3965,2005,31744,533,5823
2022-02-21,5228,3192,56171,773,18,638,281,5127,322,3965,2032,31595,504,5765
2022-02-22,5228,3192,55745,773,9,626,340,5003,307,3965,2108,34318,691,5629
2022-02-23,5228,3192,55727,773,16,624,376,4955,307,3965,2144,34462,694,5579
2022-02-24,5228,3192,55787,773,37,600,308,4659,286,3965,2158,34756,698,5259
2022-02-25,5228,3182,56355,773,14,566,313,4485,273,3955,2100,35365,689,5051
2022-02-26,5228,3182,56103,773,13,554,300,4338,282,3955,2019,32004,534,4892
2022-02-27,5228,3182,55968,773,12,539,211,4324,263,3955,2027,31696,500,4863
2022-02-28,5228,3182,56440,773,15,543,247,4221,252,3955,2136,35339,680,4764
2022-03-01,5228,3182,56522,773,13,531,312,4084,254,3955,2049,34131,711,4615
2022-03-02,5228,3182,56522,773,14,520,341,4067,252,3955,2064,34181,732,4587
2022-03-03,5228,3182,56244,773,11,510,297,4001,240,3955,2184,35534,696,4511
2022-03-04,5228,3184,56147,774,16,483,251,3884,228,3958,2174,35064,715,4367
2022-03-05,5228,3184,55384,774,14,476,242,3785,215,3958,2073,31639,672,4261
2022-03-06,5228,3184,55732,774,16,478,229,3821,218,3958,2055,31678,680,4299
2022-03-07,5228,3184,56359,774,10,475,246,3820,224,3958,2167,35184,739,4295
2022-03-08,5228,3184,55513,774,12,462,268,3703,213,3958,2226,34854,757,4165
2022-03-09,5228,3184,55513,774,8,459,265,3737,209,3958,2236,34924,765,4196
2022-03-10,5228,3184,56501,774,8,437,249,3587,206,3958,2229,35837,728,4024
2022-03-11,5228,3180,54732,775,8,424,231,3495,198,3955,2200,33954,758,3919
2022-03-12,5228,3180,55825,775,10,416,217,3398,189,3955,2151,31910,594,3814
2022-03-13,5228,3180,55916,775,2,408,187,3407,176,3955,2129,32091,564,3815
2022-03-14,5221,3173,55560,775,15,411,246,3427,184,3948,2227,34630,690,3838
2022-03-15,5221,3173,56308,775,10,385,257,3407,173,3948,2248,35643,741,3792
2022-03-16,5221,3173,56306,775,7,380,257,3324,164,3948,2243,35483,724,3704
2022-03-17,5221,3173,56298,775,7,355,249,3290,161,3948,2308,35988,679,3645
2022-03-18,5221,3174,55724,774,10,339,260,3262,147,3948,2277,35019,700,3601
2022-03-19,5221,3174,54379,774,10,335,229,3246,151,3948,2212,31111,519,3581
2022-03-20,5221,3174,54255,774,8,344,222,3306,147,3948,2116,30905,515,3650
2022-03-21,5221,3174,54813,774,14,343,262,3348,155,3948,2163,34141,682,3691
2022-03-22,5221,3174,56382,774,13,346,309,3359,158,3948,2210,36133,690,3705
2022-03-23,5221,3174,56382,774,11,346,344,3367,154,3948,2216,36168,693,3713
2022-03-24,5223,3174,56063,774,13,349,278,3404,150,3948,2179,33314,681,3753
2022-03-25,5223,3172,56239,776,15,338,329,3378,151,3948,2195,33822,653,3716
2022-03-26,5223,3172,55328,776,16,339,309,3500,146,3948,2149,31225,531,3839
2022-03-27,5223,3172,54930,776,10,343,268,3582,145,3948,2152,30665,513,3925
2022-03-28,5223,3172,56280,776,17,355,332,3584,137,3948,2171,32986,691,3939
2022-03-29,5223,3172,56064,776,14,345,334,3709,148,3948,2289,35165,708,4054
2022-03-30,5223,3172,56062,776,15,335,345,3732,148,3948,2299,35168,729,4067
2022-03-31,5216,3165,56314,776,20,320,434,3881,142,3941,2326,33422,715,4201
2022-04-01,5216,3165,55726,772,14,318,409,3949,141,3937,2322,32300,704,4267
2022-04-02,5216,3165,56023,772,22,326,399,4043,140,3937,2277,31856,549,4369
2022-04-03,5216,3165,56116,772,13,324,398,4292,145,3937,2166,31679,529,4616
2022-04-04,5216,3165,55365,772,15,344,427,4442,159,3937,2223,33584,703,4786
2022-04-05,5216,3165,56062,772,17,337,477,4584,157,3937,2302,34895,709,4921
2022-04-06,5216,3165,56062,772,14,339,470,4583,158,3937,2301,34910,710,4922
2022-04-07,5041,2990,56206,772,19,353,528,4818,159,3762,2235,32962,720,5171
2022-04-08,5041,2990,55601,772,17,359,514,4800,165,3762,2213,32538,714,5159
2022-04-09,5041,2990,55597,772,14,369,419,4962,166,3762,2176,31072,570,5331
2022-04-10,5041,2990,55701,772,10,370,393,5183,156,3762,2143,31060,564,5553
2022-04-11,5041,2990,55378,772,20,381,503,5284,160,3762,2201,33213,714,5665
2022-04-12,5041,2990,55072,772,34,396,532,5486,170,3762,2220,33353,738,5882
2022-04-13,5041,2990,55072,772,27,400,507,5486,171,3762,2232,33306,743,5886
2022-04-14,5041,2990,55378,772,14,393,606,5709,168,3762,2161,31582,707,6102
2022-04-15,5041,2990,55583,772,23,418,522,5738,177,3762,2145,31082,550,6156
2022-04-16,5041,2990,54701,772,13,426,464,5780,169,3762,2110,30111,536,6206
2022-04-17,5041,2990,55303,772,11,419,413,5974,175,3762,2096,30177,543,6393
2022-04-18,5041,2990,55394,772,20,433,479,6168,178,3762,2124,30568,565,6601
2022-04-19,5041,3002,56075,770,17,429,510,6209,177,3772,2229,34111,724,6638
2022-04-20,5041,3002,56075,770,20,425,518,6172,173,3772,2229,34049,725,6597
2022-04-21,5041,3002,56080,770,15,403,530,6280,161,3772,2344,32573,735,6683
2022-04-22,5041,3000,56099,771,20,407,606,6239,159,3771,2322,32454,722,6646
2022-04-23,5039,2998,55692,773,26,430,509,6232,169,3771,2305,30895,549,6662
2022-04-24,5039,2998,55850,773,9,427,402,6338,173,3771,2148,30739,538,6765
2022-04-25,5039,2998,55726,773,25,428,508,6439,174,3771,2218,33404,710,6867
2022-04-26,5037,2996,55658,773,19,418,548,6367,171,3769,2216,32034,663,6785
2022-04-27,5039,2998,55655,771,22,429,553,6374,176,3769,2212,32036,666,6803
2022-04-28,5214,3173,56238,771,27,422,532,6347,174,3944,2306,32892,714,6769
2022-04-29,5214,3178,56154,774,24,395,530,6225,163,3952,2142,32564,693,6620
2022-04-30,5214,3178,55378,774,17,383,466,6157,162,3952,2138,30709,553,6540
2022-05-01,5214,3178,55448,774,21,414,355,6221,166,3952,2116,30449,541,6635
2022-05-02,5214,3178,55757,774,11,400,398,6299,163,3952,2215,33354,716,6699
2022-05-03,5214,3178,56282,774,11,400,481,6246,169,3952,2251,34648,691,6646
2022-05-04,5214,3178,56277,774,15,401,512,6269,169,3952,2249,34663,719,6670
2022-05-05,5033,3178,55207,774,14,379,450,6072,157,3952,2348,33679,703,6451
2022-05-06,5034,3209,55685,787,18,368,444,5928,146,3996,2364,33774,725,6296
2022-05-07,5034,3209,55153,787,18,357,379,5745,142,3996,2328,32597,594,6102
2022-05-08,5034,3209,55187,787,13,347,325,5852,140,3996,2187,32055,602,6199
2022-05-09,5034,3209,56086,787,16,336,358,5849,136,3996,2220,34062,743,6185
2022-05-10,5034,3209,55280,787,13,320,426,5693,139,3996,2266,33959,763,6013
2022-05-11,5034,3209,55280,787,16,324,448,5703,136,3996,2265,33981,761,6027
2022-05-12,5034,3209,55924,787,19,318,362,5525,135,3996,2335,32397,728,5843
2022-05-13,5034,3215,56052,790,13,303,383,5269,120,4005,2317,32449,728,5572
2022-05-14,5034,3215,55627,790,14,300,339,5169,122,4005,2228,31006,592,5469
2022-05-15,5034,3215,55597,790,10,313,272,5229,127,4005,2141,31011,575,5542
2022-05-16,5034,3215,56097,790,11,315,354,5194,132,4005,2188,32258,702,5509
2022-05-17,5034,3215,54929,790,15,313,377,5114,135,4005,2242,31787,731,5427
2022-05-18,5034,3215,54929,790,17,311,364,5083,134,4005,2239,31853,736,5394
2022-05-19,5034,3215,55666,790,14,313,318,4861,138,4005,2268,34726,742,5174
2022-05-20,5034,3209,56076,790,12,305,293,4425,143,3999,2256,34973,755,4730
2022-05-21,5034,3209,55898,790,18,294,263,4510,142,3999,2240,33351,594,4804
2022-05-22,5034,3209,55795,790,14,286,214,4487,136,3999,2230,32566,625,4773
2022-05-23,5034,3209,55173,790,9,281,235,4509,128,3999,2225,32752,593,4790
2022-05-24,5034,3209,55498,790,10,286,256,4439,133,3999,2304,34180,753,4725
2022-05-25,5034,3209,55498,790,7,282,284,4417,133,3999,2334,34313,733,4699
2022-05-26,5029,3208,56308,790,8,263,256,4185,117,3998,2327,30962,736,4448
2022-05-27,5029,3208,55975,788,5,240,261,4019,112,3996,2269,30595,713,4259
2022-05-28,5029,3208,55718,788,11,236,231,3896,107,3996,2293,29643,594,4132
2022-05-29,5029,3208,55367,788,10,237,208,3955,105,3996,2299,28999,598,4192
2022-05-30,5029,3208,55825,788,12,235,236,3898,106,3996,2327,30242,706,4133
2022-05-31,5029,3208,55846,788,9,221,262,3684,100,3996,2386,30876,772,3905
2022-06-01,5029,3208,55846,788,7,218,251,3651,103,3996,2391,30974,774,3869
2022-06-02,5029,3208,56264,788,6,211,266,3548,93,3996,2361,35893,716,3759
2022-06-03,5029,3203,55080,793,11,195,223,3409,81,3996,2210,34258,684,3604
2022-06-04,5029,3203,54327,793,4,188,144,3331,81,3996,2280,32946,575,3519
2022-06-05,5029,3203,54526,793,5,193,121,3300,88,3996,2260,32730,588,3493
2022-06-06,5029,3203,56097,793,11,190,249,3291,92,3996,2278,35051,619,3481
2022-06-07,5029,3203,55927,793,6,181,264,3215,90,3996,2313,35461,731,3396
2022-06-08,5029,3203,55928,793,10,184,256,3198,87,3996,2319,35585,732,3382
2022-06-09,5029,3203,56524,793,9,167,223,3152,77,3996,2347,36073,733,3319
2022-06-10,5029,3201,56079,794,6,166,257,3103,78,3995,2249,35379,727,3269
2022-06-11,5029,3201,55889,794,4,160,139,3100,75,3995,2253,34698,550,3260
2022-06-12,5029,3201,56132,794,7,158,127,3105,80,3995,2264,34481,566,3263
2022-06-13,5029,3201,56051,794,8,170,265,3099,77,3995,2270,35106,672,3269
2022-06-14,5029,3201,55385,794,7,157,222,2964,75,3995,2319,35010,713,3121
2022-06-15,5029,3201,55385,794,5,160,230,2952,75,3995,2340,35120,710,3112
2022-06-16,5029,3201,55442,794,4,151,244,2943,70,3995,2037,29404,601,3094
2022-06-17,5029,3204,54228,792,9,152,213,2853,68,3996,2044,28175,596,3005
2022-06-18,5029,3204,55772,792,6,144,133,2852,65,3996,2019,28651,574,2996
2022-06-19,5029,3204,54575,792,2,153,131,2894,66,3996,2006,28187,554,3047
2022-06-20,5029,3204,55991,792,24,164,311,2943,74,3996,2064,29522,610,3107
2022-06-21,5029,3204,55706,792,14,162,264,2965,77,3996,2053,29724,599,3127
2022-06-22,5029,3204,55688,792,10,160,290,2955,78,3996,2470,35508,693,3115
2022-06-23,5029,3204,56236,792,10,162,273,2928,77,3996,2310,30984,741,3090
2022-06-24,5029,3197,55373,790,8,151,228,2879,69,3987,2244,29943,748,3030
2022-06-25,5029,3197,55891,790,5,149,148,2868,70,3987,2204,29105,576,3017
2022-06-26,5029,3197,55341,790,6,158,124,2874,65,3987,2200,28623,543,3032
2022-06-27,5029,3197,55900,790,20,162,416,3024,66,3987,2249,29993,662,3186
2022-06-28,5029,3197,56946,790,9,163,270,3080,76,3987,2271,30924,589,3243
2022-06-29,5029,3197,56946,790,10,163,306,3084,79,3987,2283,30950,718,3247
2022-06-30,5031,3208,55633,794,6,174,279,3004,85,4002,2228,35091,686,3178
2022-07-01,5032,3208,55447,794,5,162,270,3061,83,4002,2198,33443,552,3223
2022-07-02,5033,3208,55510,794,4,162,162,3086,81,4002,2161,33754,548,3248
2022-07-03,5034,3208,55400,794,2,166,151,3147,79,4002,2203,33610,553,3313
2022-07-04,5035,3208,55413,794,18,178,521,3340,71,4002,2254,34489,685,3518
2022-07-05,5036,3208,56328,794,12,184,398,3393,78,4002,2310,35882,696,3577
2022-07-06,5036,3208,56328,794,12,185,405,3410,79,4002,2314,35895,692,3595
2022-07-07,5037,3209,55496,793,9,196,386,3502,78,4002,2306,34644,703,3698
2022-07-08,5037,3207,51443,790,18,196,368,3606,79,3997,2288,30645,692,3802
2022-07-09,5037,3207,55548,790,13,207,207,3624,76,3997,2187,33710,555,3831
2022-07-10,5037,3207,55420,790,5,204,187,3669,75,3997,2218,33527,537,3873
2022-07-11,5037,3207,54652,790,12,210,601,3869,75,3997,2242,33311,694,4079
2022-07-12,5037,3207,55437,790,18,219,463,4002,76,3997,2580,36055,707,4221
2022-07-13,5037,3207,55436,790,16,214,407,4004,77,3997,2271,34780,700,4218
2022-07-14,5037,3207,55433,789,9,209,447,4257,91,3996,2259,34439,650,4466
2022-07-15,5037,3216,55820,789,15,198,434,4254,84,4005,2203,34807,662,4452
2022-07-16,5037,3216,55642,789,9,190,209,4290,85,4005,2186,33546,531,4480
2022-07-17,5037,3216,55255,789,7,200,220,4431,81,4005,2167,32646,524,4631
2022-07-18,5037,3216,55856,789,33,225,717,4579,80,4005,2220,33678,656,4804
2022-07-19,5037,3216,55475,789,14,236,519,4827,87,4005,2295,34176,650,5063
2022-07-20,5037,3216,55475,789,14,234,521,4820,85,4005,2299,34240,652,5054
2022-07-21,5071,3229,54592,789,16,231,455,4833,86,4018,2244,33533,661,5064
2022-07-22,5071,3229,55526,789,16,240,474,4684,91,4018,2197,34279,687,4924
2022-07-23,5071,3229,54736,789,6,244,206,4682,89,4018,2183,32649,511,4926
2022-07-24,5071,3229,54689,789,2,245,221,4873,86,4018,2188,32314,492,5118
2022-07-25,5071,3229,55452,789,27,253,723,4939,95,4018,2222,33832,644,5192
2022-07-26,5071,3229,55225,789,19,271,509,5089,110,4018,2258,34065,654,5360
2022-07-27,5071,3229,55233,789,15,268,495,5073,110,4018,2266,34062,660,5341
2022-07-28,5071,3229,55709,789,17,279,423,5032,111,4018,2233,34181,657,5311
2022-07-29,5071,3229,55706,789,17,281,415,4871,110,4018,2182,33985,681,5152
2022-07-30,5071,3229,54888,789,13,281,202,4840,103,4018,2154,32326,533,5121
2022-07-31,5071,3229,54813,789,8,297,183,4812,104,4018,2098,32091,524,5109
2022-08-01,5071,3229,55506,789,30,287,530,4940,101,4018,2151,33035,546,5227
2022-08-02,5071,3229,55595,789,13,295,464,5008,104,4018,2222,33854,656,5303
2022-08-03,5071,3229,55595,789,15,296,483,5058,107,4018,2223,33868,653,5354
2022-08-04,5071,3229,55841,789,11,271,412,4835,111,4018,2198,34726,688,5106
2022-08-05,5071,3235,54665,790,10,260,372,4793,110,4025,2172,33274,644,5053
2022-08-06,5071,3235,55338,790,3,260,225,4723,108,4025,2154,33283,533,4983
2022-08-07,5071,3235,55468,790,2,262,173,4786,112,4025,2126,33278,530,5048
2022-08-08,5072,3236,56164,789,24,270,522,4741,103,4025,2190,34612,616,5011
2022-08-09,5072,3236,55771,789,13,258,414,4912,108,4025,2251,34747,679,5170
2022-08-10,5072,3236,55781,789,11,258,417,4918,109,4025,2251,34795,686,5176
2022-08-11,5072,3236,56102,789,17,255,328,4796,112,4025,2245,35008,754,5051
2022-08-12,5072,3214,55659,788,18,260,370,4700,121,4002,2236,34348,696,4960
2022-08-13,5072,3214,54774,788,7,253,194,4734,125,4002,2192,32914,563,4987
2022-08-14,5072,3214,54857,788,7,250,191,4791,122,4002,2171,32780,551,5041
2022-08-15,5072,3214,55403,788,20,241,461,4801,115,4002,2234,34026,692,5042
2022-08-16,5072,3214,55170,788,12,238,391,4893,111,4002,2295,34271,715,5131
2022-08-17,5072,3214,55144,788,11,241,397,4883,111,4002,2297,34281,700,5124
2022-08-18,5072,3214,55835,788,16,241,372,4846,112,4002,2248,34776,708,5087
2022-08-19,5072,3215,55025,787,21,240,383,4790,110,4002,2213,34096,726,5030
2022-08-20,5072,3215,55103,787,10,243,205,4773,114,4002,2169,33234,560,5016
2022-08-21,5072,3215,55038,787,7,248,158,4841,111,4002,2157,32982,558,5089
2022-08-22,5072,3215,55729,787,25,250,448,4803,102,4002,2188,34538,688,5053
2022-08-23,5071,3214,55989,788,13,257,372,4910,103,4002,2188,34985,692,5167
2022-08-24,5071,3214,55989,788,12,258,370,4915,103,4002,2190,34968,692,5173
2022-08-25,5071,3214,55655,788,19,243,296,4718,106,4002,2198,34692,674,4961
2022-08-26,5071,3219,55440,786,16,243,328,4651,102,4005,2218,34155,663,4894
2022-08-27,5071,3219,54516,786,11,255,195,4590,100,4005,2171,32576,544,4845
2022-08-28,5071,3219,54870,786,8,254,155,4656,95,4005,2174,32655,570,4910
2022-08-29,5071,3219,55214,786,24,266,445,4607,100,4005,2182,33882,677,4873
2022-08-30,5071,3219,55533,786,14,242,352,4569,103,4005,2233,34802,707,4811
2022-08-31,5071,3219,55533,786,13,238,334,4571,103,4005,2257,34869,702,4809
2022-09-01,5071,3219,54818,786,10,216,287,4455,94,4005,2249,34091,701,4671
2022-09-02,5071,3219,55313,793,11,205,285,4315,95,4012,2215,34359,674,4520
2022-09-03,5071,3219,55187,793,12,204,270,4315,90,4012,2164,33460,546,4519
2022-09-04,5071,3219,55089,793,10,200,270,4373,92,4012,2166,33204,567,4573
2022-09-05,5071,3219,54979,793,14,213,266,4264,91,4012,2205,33536,546,4477
2022-09-06,5071,3219,55015,793,12,211,364,4379,90,4012,2265,33882,687,4590
2022-09-07,5071,3219,55015,793,12,212,397,4381,91,4012,2284,34004,687,4593
2022-09-08,5255,3219,55917,793,11,202,285,4318,85,4012,2308,35401,712,4520
2022-09-09,5255,3219,56067,793,10,198,281,4215,80,4012,2280,35527,592,4413
2022-09-10,5255,3219,55366,793,9,200,165,4168,84,4012,2248,34085,571,4368
2022-09-11,5255,3219,55205,793,6,199,155,4197,87,4012,2243,33492,567,4396
2022-09-12,5255,3214,55974,788,21,201,392,4255,88,4002,2289,35088,687,4456
2022-09-13,5255,3214,56305,788,14,213,349,4236,92,4002,2301,36140,711,4449
2022-09-14,5255,3214,56305,788,16,212,343,4243,92,4002,2297,36137,708,4455
2022-09-15,5255,3214,56240,788,13,216,300,4193,89,4002,2307,36088,682,4409
2022-09-16,5255,3211,55699,785,15,214,277,4106,94,3996,2289,35314,685,4320
2022-09-17,5255,3211,53775,785,8,208,165,4057,92,3996,2232,32826,559,4265
2022-09-18,5255,3211,54159,785,7,214,151,4092,95,3996,2272,32924,532,4306
2022-09-19,5255,3211,56042,785,19,216,384,4183,93,3996,2307,35467,596,4399